24
12
O************O*********O
|H           |         |
|            O         |
|                      |
|            O      $  |
|          $ |      $  |
|            |      $  |
|       O    |         |
|*******************O  |
|  $    $   $    $     |
|    $    $   $    $   |
O**********************O